walls
150,0,900,20,1,1,1
150,780,900,20,1,1,1
1030,20,20,130,1,1,1
1030,200,20,580,1,1,1
150,20,20,253,1,1,1
150,526,20,254,1,1,1
door
150,273,20,253,1,1,1
exit
1030,150,20,50,1,1,1
enemies
400,600,40,40,0,0,1,0
800,400,40,40,1,0,0,1
180,100,75,75,0.59,0.21,0.11,0
